"filename", "language", "C++", "Makefile", "Markdown", "comment", "blank", "total"
"/Users/ahouari/Desktop/triz_work/contonirs/Makefile", "Makefile", 0, 0, 0, 0, 1, 1
"/Users/ahouari/Desktop/triz_work/contonirs/README.md", "Markdown", 0, 0, 2, 0, 1, 3
"/Users/ahouari/Desktop/triz_work/contonirs/containers/RB_tree.hpp", "C++", 545, 0, 0, 87, 113, 745
"/Users/ahouari/Desktop/triz_work/contonirs/containers/map.hpp", "C++", 300, 0, 0, 137, 105, 542
"/Users/ahouari/Desktop/triz_work/contonirs/containers/set.hpp", "C++", 203, 0, 0, 0, 73, 276
"/Users/ahouari/Desktop/triz_work/contonirs/containers/stack.hpp", "C++", 58, 0, 0, 12, 25, 95
"/Users/ahouari/Desktop/triz_work/contonirs/containers/vector.hpp", "C++", 370, 0, 0, 139, 118, 627
"/Users/ahouari/Desktop/triz_work/contonirs/iterators/RBT_iterator.hpp", "C++", 132, 0, 0, 0, 31, 163
"/Users/ahouari/Desktop/triz_work/contonirs/iterators/iterator_traits.hpp", "C++", 96, 0, 0, 11, 27, 134
"/Users/ahouari/Desktop/triz_work/contonirs/iterators/random_access_iterator.hpp", "C++", 96, 0, 0, 11, 27, 134
"/Users/ahouari/Desktop/triz_work/contonirs/iterators/reverse_iterator.hpp", "C++", 113, 0, 0, 11, 23, 147
"/Users/ahouari/Desktop/triz_work/contonirs/tester.cpp", "C++", 0, 0, 0, 0, 1, 1
"/Users/ahouari/Desktop/triz_work/contonirs/type_traits.../enable_if.hpp", "C++", 8, 0, 0, 11, 6, 25
"/Users/ahouari/Desktop/triz_work/contonirs/type_traits.../is_ingeral.hpp", "C++", 31, 0, 0, 13, 12, 56
"/Users/ahouari/Desktop/triz_work/contonirs/type_traits.../lexicographical&&comp.hpp", "C++", 62, 0, 0, 15, 14, 91
"/Users/ahouari/Desktop/triz_work/contonirs/type_traits.../pair.hpp", "C++", 61, 0, 0, 11, 12, 84
"/Users/ahouari/Desktop/triz_work/contonirs/unit_tests/map_tests.cpp", "C++", 272, 0, 0, 0, 88, 360
"/Users/ahouari/Desktop/triz_work/contonirs/unit_tests/set_tests.cpp", "C++", 0, 0, 0, 0, 1, 1
"/Users/ahouari/Desktop/triz_work/contonirs/unit_tests/stack_tests.cpp", "C++", 115, 0, 0, 0, 10, 125
"/Users/ahouari/Desktop/triz_work/contonirs/unit_tests/vector_tests.cpp", "C++", 322, 0, 0, 0, 83, 405
"Total", "-", 2784, 0, 2, 458, 771, 4015